0 35 26 26 26 26 26 26 26 26 26 26 26 38 0 0 21 0 0 0 0 0 0 0 0 0 0 0 21 0 0 25 26 18 26 26 26 26 26 26 26 18 26 28 0 0 0 0 21 0 0 0 0 0 0 0 21 0 0 0 19 26 26 24 26 30 0 71 0 27 26 24 26 26 22 21 0 0 0 0 0 0 21 0 0 0 0 0 0 21 21 0 43 26 26 26 18 24 18 26 26 26 46 0 21 21 0 0 0 0 0 21 0 21 0 0 0 0 0 21 25 26 18 26 26 26 20 0 17 26 26 26 18 26 28 0 0 21 0 0 0 21 0 21 0 0 0 21 0 0 27 26 16 26 26 26 20 0 17 26 26 26 16 26 30 0 0 21 0 0 0 17 18 20 0 0 0 21 0 0 19 26 24 26 26 26 24 16 24 26 26 26 24 26 22 21 0 0 0 0 0 0 21 0 0 0 0 0 0 21 25 26 26 26 26 26 26 72 26 26 26 26 26 26 28 
0 0 0 0 0 0 0 0 0 0 0 0 0 0 0 19 26 26 26 26 26 26 26 22 0 19 26 26 26 46 21 0 0 0 0 0 0 0 21 0 21 0 0 0 0 21 0 35 26 26 26 22 0 21 0 17 26 26 26 78 21 0 21 0 0 0 21 0 21 0 21 0 0 0 0 21 0 25 26 26 26 20 0 21 0 17 26 26 26 46 21 0 0 0 0 0 21 0 21 0 21 0 0 0 0 21 0 19 26 18 26 20 0 25 26 24 26 26 26 22 21 0 21 0 21 0 21 0 0 0 0 0 0 0 21 21 0 21 0 21 0 25 26 26 26 26 26 30 0 21 25 26 20 0 21 0 0 0 0 0 0 0 0 0 21 0 0 17 26 24 26 18 26 26 26 18 26 26 26 20 0 0 21 0 0 0 21 0 0 0 21 0 0 0 21 43 26 24 26 26 26 24 26 78 0 25 26 26 26 28 0 0 0 0 0 0 0 0 0 0 0 0 0 0 0 
19 26 26 18 22 0 39 0 39 0 19 18 26 26 22 21 0 0 17 20 0 25 18 28 0 17 20 0 0 21 17 26 26 24 20 0 0 21 0 0 17 24 26 26 20 21 0 0 0 17 18 26 24 26 18 20 0 0 0 21 17 26 26 26 24 20 0 0 0 17 24 26 26 26 20 21 0 0 0 0 21 0 39 0 21 0 0 0 0 21 25 26 26 26 26 24 18 16 18 24 26 26 26 26 28 0 0 0 0 0 0 17 64 20 0 0 0 0 0 0 19 26 26 26 26 18 24 16 24 18 26 26 26 26 22 21 0 0 0 0 21 0 45 0 21 0 0 0 0 21 17 26 26 26 18 20 0 0 0 17 18 26 26 26 20 21 0 0 0 17 24 26 18 26 24 20 0 0 0 21 17 26 26 18 20 0 0 21 0 0 17 18 26 26 20 21 0 0 17 20 0 19 24 22 0 17 20 0 0 21 25 26 26 24 28 0 45 0 45 0 25 24 26 26 28 
19 26 26 26 26 26 22 0 19 26 26 22 0 0 0 21 0 0 0 0 0 21 0 21 0 0 21 0 0 0 17 26 26 26 22 0 25 26 20 0 0 17 26 26 22 21 0 0 0 21 0 0 0 17 26 26 20 0 0 21 21 0 0 0 21 0 0 0 21 0 0 21 0 0 21 17 26 30 0 21 0 27 26 28 0 0 25 26 26 20 21 0 0 0 21 0 0 0 0 0 0 0 0 0 21 17 26 30 0 25 42 42 74 42 42 26 26 22 0 21 21 0 0 0 0 0 0 0 0 0 0 0 21 0 21 17 26 26 22 0 0 0 23 0 0 23 0 21 0 21 21 0 0 17 26 26 26 20 0 0 21 0 21 0 21 21 0 0 21 0 0 0 17 26 26 20 0 21 0 21 25 26 26 20 0 0 0 21 0 0 21 0 21 0 21 0 0 0 17 26 26 26 20 0 0 21 0 21 0 21 0 0 0 29 0 0 0 25 26 26 24 26 24 26 28 
19 18 18 18 18 18 18 18 18 18 18 18 18 18 22 17 16 16 24 16 16 16 16 16 16 16 16 16 16 20 17 16 68 0 33 16 16 16 16 16 16 16 16 16 20 17 16 16 18 16 16 16 16 16 16 16 16 16 16 20 17 16 16 16 16 16 16 16 16 16 16 16 16 16 20 17 16 16 16 16 16 16 16 16 16 16 16 16 16 20 17 16 16 16 16 16 16 16 16 16 16 16 16 16 20 17 16 16 16 16 16 16 64 16 16 16 16 16 16 20 17 16 16 16 16 16 16 16 16 16 16 16 16 16 20 17 16 16 16 16 16 16 16 16 16 16 16 16 16 20 17 16 16 16 16 16 16 16 16 16 16 16 16 16 20 17 16 16 16 16 16 16 16 16 16 16 16 16 16 20 17 16 16 16 16 16 16 16 16 16 16 16 16 16 20 17 16 16 16 16 16 16 16 16 16 16 16 16 16 20 25 24 24 24 24 24 24 24 24 24 24 24 24 24 28 
19 18 18 18 18 18 18 18 18 18 18 18 18 18 22 17 16 16 24 24 24 24 24 24 24 24 24 24 16 20 17 16 20 0 0 0 0 0 0 0 0 0 0 17 20 17 16 16 18 18 18 22 0 0 19 18 18 18 16 20 17 16 16 16 16 16 16 18 18 16 16 16 16 16 20 17 16 16 16 16 16 16 16 16 16 16 16 16 16 20 17 16 16 16 16 16 16 16 16 16 16 16 16 16 20 17 16 16 16 16 16 16 64 16 16 16 16 16 16 20 17 16 16 16 16 16 16 16 16 16 16 16 16 16 20 17 16 16 16 16 16 16 16 16 16 16 16 16 16 20 17 16 16 16 16 16 16 16 16 16 16 16 16 16 20 17 16 16 16 16 16 16 16 16 16 16 16 16 16 20 17 16 16 16 16 16 16 16 16 16 16 16 16 16 20 17 16 16 16 16 16 16 16 16 16 16 16 16 16 20 25 24 24 24 24 24 24 24 24 24 24 24 24 24 28 
